8 15
|-------------|
|..F|P.......F|
|F..-....P.|..|
|...-.@|...|.P|
|..F...|.F.|-F|
|....--|.--|..|
|.P.....P.|P..|
|-------------|